1111111
1011C11
1011E11
1111001
11111111