111111111111111111111111111111111
1000010000100000010000C0001000001
1000101E1101100001000000000000001
1000100001000010000C0P01010110001
10001C0001100010011110010110001C1
101000100000000000C00001001101111
10000010000100010000C000100000001
111111111111111111111111111111111