1111111111111111111111111111111111
100100000000000C00000C000000000001
101C110100100100101001110000010101
1110010010101E10001001000100010101
100000000C00C0000000100P00100000C1
1111111111111111111111111111111111