1111111111111111111111111111111111
100000000000000C00000C000000000001
1010010100100100101001010000010101
1010010010101E10001001000100010101
100000000C00C0000000000P00000000C1
1111111111111111111111111111111111